**********
* .      *
*  ***P  *
*.       *
*.       *
****     *
*1 *     *
*        *
**********
